4 4 4 4 4 4 4 0 0 4 4 4 4 4 4 4 4 4
4 6 0 0 0 0 0 0 0 0 0 0 0 0 0 0 6 4
4 0 0 0 0 0 0 0 0 0 0 0 0 0 0 0 0 4
4 0 0 1 0 0 0 0 0 1 2 0 0 0 0 0 0 4
4 0 0 0 0 0 0 2 2 0 0 0 0 0 0 0 0 4
4 0 0 0 0 1 3 3 3 3 2 0 0 0 1 0 0 4
4 0 0 0 0 3 3 3 3 3 3 0 0 0 0 0 0 4
4 0 0 0 0 2 3 3 3 3 1 0 0 0 0 0 0 4
4 0 0 0 0 0 0 2 2 0 0 0 0 0 0 0 0 4
4 0 0 0 2 0 0 0 0 0 0 1 0 0 0 0 0 4
4 0 0 0 0 0 0 0 0 0 0 0 0 0 0 0 0 4
4 0 0 0 0 0 0 0 0 0 0 0 0 0 0 0 0 4
4 6 0 0 0 0 0 0 0 0 0 0 0 0 0 0 6 4
4 4 4 4 4 4 4 4 4 4 4 4 4 4 4 4 4 4